11000010111
11001111101
10111100011
10100111110
11111001111